XXXXXXXXXXXXXXXXXXXXXXXX
X......................X
X......................X
X......................X
X......................X
X......................X
X......................X
X......................T
X>.....................X
X......................X
X......................X
X......................X
X......................X
X......................X
X......................X
X......................R
X......................X
X......................X
X......................X
X......................X
X......................X
X......................X
X..........^...........X
XXXXXXXXXXXXXXXXXXXXXXXX