Level 2
XXXXXXXXXXXRXXXXXXXXXXXX
X......................X
X>.....................T
X......................X
X......................X
X......................X
X......................X
X......................X
X......................X
X......................X
X......................X
X......................X
X......................X
X......................X
X......................X
X......................X
X......................X
X......................X
X......................X
X......................X
X......................X
X......................X
X......................X
XXXXXXXXXXXXXXXXXXXXXXXX