Level 1
XXXXXXXXXXXRXXXXXXXXXXXX
X......X.......X.......X
X>.....X.......X.......T
X......X.......X.......X
X......X.......X.......X
X......X.......X.......X
X......X.......X.......X
X......X.......X.......X
X......X.......X.......X
X......X.......X.......X
X......X.......X.......X
X......X.......X.......X
X......X.......X.......X
X......X.......X.......X
X......X.......X.......X
X......................X
X......................X
X......................X
X......................X
X......................X
X......................X
X......................X
X......................X
XXXXXXXXXXXXXXXXXXXXXXXX