XXXXXXXXXXXXXXXXXXXXXXXX
X......................X
X......................X
X......................X
X......................X
X......................X
X......................X
X......................X
XL.....................X
X......................X
X......................X
X......................X
X......................X
X......................X
X......................X
X......................X
X......................X
X......................X
X......................X
X......................X
X......................X
X......................X
X......................X
XXXXXXXXXXXXXXXXXXXXXXXX